########################
#  s         #         #
#            #       f #
##########   #         #
#            #    ######
#       ###  #         #
#         ####         #
#         #            #
#                      #
########################