##########
# S #  F #
#   #    #
#        #
##########